//MAP CONVERTED BY dmm2tgm.py THIS HEADER COMMENT PREVENTS RECONVERSION, DO NOT REMOVE
"a" = (
/turf/open/floor/mineral/titanium/white,
/area/shuttle/pod_1)
"h" = (
/turf/closed/wall/mineral/titanium,
/area/shuttle/pod_1)
"o" = (
/obj/structure/chair/comfy/shuttle{
	dir = 8
	},
/obj/structure/chair/comfy/shuttle{
	dir = 8
	},
/obj/machinery/status_display/evac/directional/east,
/turf/open/floor/mineral/plastitanium/red/brig,
/area/shuttle/pod_1)
"s" = (
/obj/structure/table,
/obj/machinery/recharger{
	pixel_x = 6;
	pixel_y = 3
	},
/obj/item/book/manual/wiki/security_space_law{
	pixel_x = -6;
	pixel_y = 2
	},
/obj/machinery/light/directional/north{
	dir = 4
	},
/turf/open/floor/mineral/titanium/white,
/area/shuttle/pod_1)
"x" = (
/obj/structure/chair/comfy/shuttle{
	dir = 4
	},
/obj/structure/chair/comfy/shuttle{
	dir = 4
	},
/obj/machinery/status_display/evac/directional/west,
/turf/open/floor/mineral/plastitanium/red/brig,
/area/shuttle/pod_1)
"D" = (
/obj/effect/spawner/structure/window/reinforced/shuttle,
/turf/open/floor/plating,
/area/shuttle/pod_1)
"E" = (
/obj/structure/chair/comfy/shuttle{
	dir = 8
	},
/obj/machinery/light/directional/north{
	dir = 4
	},
/turf/open/floor/mineral/plastitanium/red/brig,
/area/shuttle/pod_1)
"H" = (
/obj/structure/chair/comfy/shuttle{
	dir = 4
	},
/obj/machinery/light/directional/north{
	dir = 8
	},
/turf/open/floor/mineral/titanium/white,
/area/shuttle/pod_1)
"J" = (
/turf/template_noop,
/area/template_noop)
"K" = (
/obj/structure/window/reinforced{
	dir = 1
	},
/obj/structure/chair/comfy/shuttle{
	dir = 8
	},
/turf/open/floor/mineral/titanium/white,
/area/shuttle/pod_1)
"L" = (
/turf/open/floor/mineral/plastitanium/red/brig,
/area/shuttle/pod_1)
"N" = (
/obj/machinery/door/window/brigdoor{
	dir = 1;
	req_access_txt = "2"
	},
/turf/open/floor/mineral/titanium/white,
/area/shuttle/pod_1)
"P" = (
/obj/machinery/door/airlock/titanium{
	name = "Shuttle Airlock"
	},
/obj/docking_port/mobile/pod{
	dwidth = 2;
	height = 6;
	port_direction = 2;
	width = 5
	},
/turf/open/floor/mineral/titanium/blue,
/area/shuttle/pod_1)
"Q" = (
/obj/structure/shuttle/engine/propulsion/burst,
/turf/closed/wall/mineral/titanium,
/area/shuttle/pod_1)
"R" = (
/obj/structure/window/reinforced{
	dir = 1
	},
/obj/machinery/computer/shuttle/pod{
	pixel_x = -32
	},
/obj/structure/chair/comfy/shuttle{
	dir = 4
	},
/turf/open/floor/mineral/titanium/white,
/area/shuttle/pod_1)
"S" = (
/obj/structure/chair/comfy/shuttle{
	dir = 4
	},
/obj/item/storage/pod{
	pixel_x = -26
	},
/turf/open/floor/mineral/titanium/white,
/area/shuttle/pod_1)
"X" = (
/obj/structure/chair/comfy/shuttle{
	dir = 4
	},
/obj/machinery/light/directional/north{
	dir = 8
	},
/turf/open/floor/mineral/plastitanium/red/brig,
/area/shuttle/pod_1)
"Y" = (
/obj/structure/chair/comfy/shuttle{
	dir = 8
	},
/obj/item/radio/intercom/directional/east,
/turf/open/floor/mineral/titanium/white,
/area/shuttle/pod_1)

(1,1,1) = {"
J
h
h
h
h
h
h
Q
"}
(2,1,1) = {"
h
h
X
x
R
S
H
h
"}
(3,1,1) = {"
D
L
L
L
N
a
a
P
"}
(4,1,1) = {"
h
h
E
o
K
Y
s
h
"}
(5,1,1) = {"
J
h
h
h
h
h
h
Q
"}
