//MAP CONVERTED BY dmm2tgm.py THIS HEADER COMMENT PREVENTS RECONVERSION, DO NOT REMOVE
"a" = (
/obj/structure/chair/comfy/shuttle{
	dir = 8
	},
/obj/item/radio/intercom/directional/north,
/turf/open/floor/mineral/titanium/blue,
/area/shuttle/pod_1)
"f" = (
/obj/structure/chair/comfy/shuttle{
	dir = 8
	},
/obj/structure/chair/comfy/shuttle{
	dir = 8
	},
/turf/open/floor/mineral/titanium/blue,
/area/shuttle/pod_1)
"h" = (
/turf/closed/wall/mineral/titanium,
/area/shuttle/pod_1)
"k" = (
/turf/open/floor/mineral/titanium/blue,
/area/shuttle/pod_1)
"n" = (
/obj/effect/turf_decal/trimline/blue/end{
	dir = 1
	},
/obj/effect/turf_decal/trimline/blue/mid_joiner{
	dir = 4
	},
/obj/effect/turf_decal/trimline/blue/mid_joiner{
	dir = 8
	},
/obj/effect/turf_decal/trimline/blue/mid_joiner{
	dir = 1
	},
/turf/open/floor/mineral/titanium/white,
/area/shuttle/pod_1)
"s" = (
/obj/effect/turf_decal/trimline/blue/end,
/obj/effect/turf_decal/trimline/blue/mid_joiner{
	dir = 4
	},
/obj/effect/turf_decal/trimline/blue/mid_joiner{
	dir = 8
	},
/obj/effect/turf_decal/trimline/blue/mid_joiner,
/turf/open/floor/mineral/titanium/white,
/area/shuttle/pod_1)
"t" = (
/obj/structure/table,
/turf/open/floor/mineral/titanium/white,
/area/shuttle/pod_1)
"u" = (
/obj/structure/chair/comfy/shuttle{
	dir = 4
	},
/obj/item/storage/pod{
	pixel_x = 5;
	pixel_y = 29
	},
/turf/open/floor/mineral/titanium/blue,
/area/shuttle/pod_1)
"w" = (
/obj/machinery/stasis{
	dir = 8
	},
/turf/open/floor/mineral/titanium/white,
/area/shuttle/pod_1)
"A" = (
/obj/machinery/computer/shuttle/monastery_shuttle,
/obj/machinery/light/directional/north,
/turf/open/floor/mineral/titanium/blue,
/area/shuttle/pod_1)
"D" = (
/obj/effect/spawner/structure/window/reinforced/shuttle,
/turf/open/floor/plating,
/area/shuttle/pod_1)
"E" = (
/obj/structure/chair/comfy/shuttle{
	dir = 4
	},
/obj/structure/chair/comfy/shuttle{
	dir = 4
	},
/turf/open/floor/mineral/titanium/blue,
/area/shuttle/pod_1)
"G" = (
/obj/machinery/status_display/evac/directional/east,
/obj/effect/turf_decal/trimline/blue/end{
	dir = 4
	},
/obj/machinery/light/directional/north{
	dir = 4
	},
/obj/effect/turf_decal/trimline/blue/mid_joiner{
	dir = 1
	},
/obj/effect/turf_decal/trimline/blue/mid_joiner{
	dir = 4
	},
/obj/effect/turf_decal/trimline/blue/mid_joiner,
/turf/open/floor/mineral/titanium/white,
/area/shuttle/pod_1)
"J" = (
/turf/template_noop,
/area/template_noop)
"K" = (
/obj/structure/window/reinforced{
	dir = 1
	},
/obj/machinery/computer/operating,
/turf/open/floor/mineral/titanium/white,
/area/shuttle/pod_1)
"P" = (
/obj/machinery/door/airlock/titanium{
	name = "Shuttle Airlock"
	},
/obj/docking_port/mobile/pod{
	dwidth = 2;
	height = 6;
	port_direction = 2;
	width = 5
	},
/turf/open/floor/mineral/titanium/blue,
/area/shuttle/pod_1)
"Q" = (
/obj/structure/shuttle/engine/propulsion/burst,
/turf/closed/wall/mineral/titanium,
/area/shuttle/pod_1)
"R" = (
/obj/effect/turf_decal/trimline/blue/corner{
	dir = 4
	},
/obj/effect/turf_decal/trimline/blue/corner{
	dir = 8
	},
/obj/effect/turf_decal/trimline/blue/corner{
	dir = 1
	},
/obj/effect/turf_decal/trimline/blue/corner,
/obj/effect/turf_decal/trimline/blue,
/obj/effect/turf_decal/trimline/blue/mid_joiner{
	dir = 4
	},
/obj/effect/turf_decal/trimline/blue/mid_joiner{
	dir = 1
	},
/obj/effect/turf_decal/trimline/blue/mid_joiner{
	dir = 8
	},
/obj/effect/turf_decal/trimline/blue/mid_joiner,
/turf/open/floor/mineral/titanium/white,
/area/shuttle/pod_1)
"V" = (
/obj/structure/window/reinforced{
	dir = 1
	},
/obj/machinery/stasis{
	dir = 8
	},
/turf/open/floor/mineral/titanium/white,
/area/shuttle/pod_1)
"W" = (
/obj/machinery/status_display/evac/directional/west,
/obj/effect/turf_decal/trimline/blue/end{
	dir = 8
	},
/obj/structure/table/optable,
/obj/machinery/light/directional/north{
	dir = 8
	},
/obj/effect/turf_decal/trimline/blue/mid_joiner{
	dir = 1
	},
/obj/effect/turf_decal/trimline/blue/mid_joiner{
	dir = 8
	},
/obj/effect/turf_decal/trimline/blue/mid_joiner,
/turf/open/floor/mineral/titanium/white,
/area/shuttle/pod_1)

(1,1,1) = {"
J
h
D
D
h
h
h
Q
"}
(2,1,1) = {"
h
h
u
E
K
W
t
h
"}
(3,1,1) = {"
D
A
k
k
n
R
s
P
"}
(4,1,1) = {"
h
h
a
f
V
G
w
h
"}
(5,1,1) = {"
J
h
D
D
h
h
h
Q
"}
